11111111111111111111
1010010C110C001110C1
1CC0C10CC0C0001CCC01
1C1C100CCC110C000011
100C01C101C0C010C001
100C0CCC010100010C11
101C00110111001P0101
111C00E0001000CC0C11
10C00CC1C1C01CC01011
11111111111111111111
