11111111111111111
1E00C0011100C10C1
10X00000010001001
10111111P10111001
1CCCCCX0000000001
10001111101111101
10111X01C01000001
10000001C01011001
1CCC110CC000010C1
11111111111111111
