111111111111111
10001000001C001
111010111010101
1E1010100010101
101010101110101
10100010P010101
1C1111111010101
10000000100C1C1
101011111111101
1010000000C0001
111111111111111
