1111111111111111111111111
1000100C0010C000000010001
111010111C101111111010101
1010101000101010000010101
101C101011101010111110111
1010001000101010001000001
1011111110101011101111101
10000000100010P01CE010001
1010111111111C11111010101
101010000010C0000010001C1
1011101010101111101111101
10100010101010C0100010001
1010111011101110111010111
100000100000000C001000001
1111111111111111111111111
