1111111
10P0101
1110101
1010101
101C1C1
100E001
1111111
