111111111
100000101
111110101
100X101E1
10111C101
101000101
101011101
100P0C001
111111111
