1111111
1000XX1
1111101
10P0101
10111E1
100C001
1111111
