111111111111111
101010000000001
1010101E1111101
1010C010101CPC1
101111101010111
1010C0001010101
101011111010101
1X00100X0010001
111110111111101
10000000000X0C1
111111111111111
