1111111111
10100C0011
1011111011
1000100011
111E1C1011
1010001011
1011111011
10000P0011
1111111111
1111111111
