1111111
1010E01
10111C1
100X101
111P101
1000001
1111111
